the realm of	短语架构语块
discover…connection to 	短语架构语块
get up close to 	短语架构语块
through the eyes of 	短语架构语块
explore the effects of	短语架构语块
the role it plays 	多元词
Find out 	多元词
across cultures and time	多元词
found creative ways 	短语架构语块
neutralise and harness 	短语架构语块
 the properties of 	短语架构语块
 in humans	多元词
learn about	短语架构语块
in under five minutes	多元词
at the Museum	短语架构语块
pervades the natural and human world	短语架构语块
in the way	多元词
served up	习俗语语块
for free	多元词
is setting for	短语架构语块
 sign up 	多元词
a range of 	短语架构语块
as well as	短语架构语块
Take a seat 	习俗语语块
after hours 	多元词
take part in	短语架构语块
one of the	短语架构语块
for the first time	多元词
Travel back  to	短语架构语块
50 million years	多元词
the beginning of 	短语架构语块
the evolution of 	短语架构语块
compare  to	短语架构语块
 get up close to	短语架构语块
 face to face 	多元词
This exhibition brings	句子构建语块
 for decades	短语架构语块
On the trail of	短语架构语块
below the ocean's surface	短语架构语块
over the past 300 years	短语架构语块
every four months	短语架构语块
be invited to 	短语架构语块
under the sea 	短语架构语块
send off	习俗语语块
have the chance to 	短语架构语块
down to midnight	多元词
It’s just like	句子构建语块
but instead of	短语架构语块
with the chance to 	短语架构语块
come out of 	习俗语语块
Got a question?	句子构建语块
at all times.	多元词
set up	习俗语语块
it wasn’t until	句子构建语块
there will be 	句子构建语块
Please note 	句子构建语块
If there is	句子构建语块
on the loose	短语架构语块
It’s up to you to 	句子构建语块
 carry out 	多元词
 be vital in 	短语架构语块
Due to 	多元词
be aware that 	习俗语语块
are available for	习俗语语块
subject to	习俗语语块
as long as 	短语架构语块
at least 30 days 	短语架构语块
before the date 	短语架构语块
reserves the right to 	短语架构语块
at any time	多元词
on display 	多元词
hundreds of millions of years old	多元词
thanks to?	多元词
known as 	多元词
a example of 	短语架构语块
 the same as 	短语架构语块
the result of 	短语架构语块
in collaboration with 	短语架构语块
in the eye	多元词
This is your chance	习俗语语块
range from…to…	短语架构语块
preserved specimens	多元词
be classified by	短语架构语块
be gazed upon	短语架构语块
The exhibit highlights…	句子构建语块
In this web site explore objects that…	句子构建语块
 in the realms of 	短语架构语块
Included are…	句子构建语块
is located in 	短语架构语块
permanent exhibition	多元词
went on exhibit/view	短语架构语块
Also on view for the first time are…	句子构建语块
on public display	多元词
takes you from ... all the way down to …	短语架构语块
travel through time	多元词
invites visitors to 	多元词
This new exhibition will dive deep into…	句子构建语块
face to face	多元词
Free admission	多元词
On entering 	短语架构语块
Over the course of a week/month	短语架构语块
a changing series of	短语架构语块
Throughout your life	多元词
the end of life	短语架构语块
The results of	短语架构语块
The remarkable use of	短语架构语块
What's on	多元词
was best known for	短语架构语块
it wasn抰 until	句子构建语块
teeming with life	多元词
a bit of	短语架构语块
If there is	句子构建语块
It is astonishing to think that	句子构建语块
Thinking that	句子构建语块
Please click on	句子构建语块
The curious case of	短语架构语块
The last person to see	短语架构语块
is created by 	习俗语语块
are responsible for	习俗语语块
The shape of 	短语架构语块
in the late 18th century	多元词
is available to	习俗语语块
For print sales please visit	句子构建语块
too late to get	短语架构语块
Keep an eye out on 	句子构建语块
is expected to be 	习俗语语块
a series of outdoor exhibitions	短语架构语块
be uploaded onto	习俗语语块
keep an eye on 	习俗语语块
providing the audience with 	习俗语语块
an unique visual experience	多元词
a number of 	短语架构语块
meet all the challenges	习俗语语块
a wide variety of different environments	短语架构语块
have an advantage over	短语架构语块
are linked to	短语架构语块
this is called	句子构建语块
a wide range of	短语架构语块
large and small	多元词
was essential for	短语架构语块
in response to	短语架构语块
make use of	短语架构语块
Over time	多元词
turn these signals into an image	短语架构语块
make it possible	短语架构语块
stood at a crossroads of	短语架构语块
over time 	多元词
and so did trade routes	句子构建语块
It starts with	句子构建语块
a group of	短语架构语块
a sign of	短语架构语块
above all	多元词
With less than one	多元词
emerge at	短语架构语块
was made possible by 	短语架构语块
was organized by	短语架构语块
such as	句子构建语块
make it possible to	短语架构语块
the wide range of 	短语架构语块
as well as	句子构建语块
Millions of years ago	习俗语语块
Neither birds nor bats	句子构建语块
glide through the air	短语架构语块
was faced with 	短语架构语块
a matter of ego	多元词
so did science	短语架构语块
by the age of 15	短语架构语块
a 13-year-old cadet	短语架构语块
With few exceptions	短语架构语块
and one only	多元词
out of luck	习俗语语块
If they didn't	句子构建语块
partly due to	短语架构语块
too little information to avoid tragedy	短语架构语块
one of the greatest tales	习俗语语块
was forced to	短语架构语块
one of which	句子构建语块
on the ground	多元词
the life and death of the stars	习俗语语块
unfolding story that 	句子构建语块
Journey to the Stars	短语架构语块
with the cooperation of	短语架构语块
More than 13 billion years ago	习俗语语块
along with	短语架构语块
everywhere around the world	多元词
of which about	句子构建语块
are classified into	短语架构语块
thousands of scales	短语架构语块
play an important role 	短语架构语块
large or small	多元词
get free admission to	短语架构语块
"at depths of up to 1,000 feet"	短语架构语块
Once upon a time	多元词
instead of science	短语架构语块
At the time	多元词
Paleontologists suggest that	句子构建语块
then and now 	多元词
in fundamentally different ways	短语架构语块
a herd of	短语架构语块
With a bit of luck you can	句子构建语块
have a go at	习俗语语块
In the temporary	多元词
Come and see a lot more	习俗语语块
In doing so	习俗语语块
In this room are	句子构建语块
in other words	习俗语语块
"To start with,"	习俗语语块
in between	多元词
Note:	句子构建语块
along with	短语架构语块
branching paths	多元词
interactive tools	多元词
reveal the adaptations	多元词
corresponding display case	多元词
life stages	多元词
the fertilisation of the ovum	多元词
surface area	多元词
at the end of	短语架构语块
the Triassic period	短语架构语块
national treasure	多元词
an optimal view	多元词
In the basement	多元词
iguanodon expert	多元词
the marks of many an injury	多元词
cervical vertebrae 	多元词
be located midway on	短语架构语块
underlie these changes	多元词
be believed to be	短语架构语块
have an undeniable impact on	短语架构语块
It’s not very likely	句子构建语块
get a better idea of	短语架构语块
Allow yourself to	句子构建语块