Please_UH note_VV this_DT exhibition_NN contains_VVZ images_NNS that_IN/that some_DT may_MD find_VV distressing_JJ ._SENT	注意事项
Please_UH be_VB aware_JJ that_IN/that you_PP may_MD miss_VV some_DT of_IN the_DT activities_NNS if_IN you_PP arrive_VVP late_RB ._SENT	注意事项
Richard_NP Sabin_NP ,_, whale_NN expert_NN at_IN the_DT Museum_NP ,_, says_VVZ ,_, '_'' Whales_NP are_VBP incredibly_RB mysterious_JJ and_CC complex_JJ creatures_NNS ,_, and_CC the_DT giants_NNS of_IN the_DT seas_NNS ._SENT '_''	引用他人
Ever_RB wanted_VVD to_TO look_VV a_DT koala_NN ,_, a_DT hippopotamus_NN ,_, or_CC a_DT gorilla_NN in_IN the_DT eye_NN ?_SENT	引起读者兴趣
Ever_RB wonder_VV what_WP happens_VVZ in_IN the_DT Museum_NP when_WRB everyone_NN 's_VBZ gone_VVN home_RB ?_SENT	引起读者兴趣
So_RB massive_JJ !_SENT So_RB tall_JJ !_SENT Such_JJ long_JJ necks_NNS and_CC tiny_JJ heads_NNS !_SENT But_CC more_RBR astounding_VVG is_VBZ this_DT :_:	引起读者兴趣
Small_JJ and_CC shy_JJ —_NN or_CC big_JJ and_CC fierce_JJ ?_SENT Bright_JJ as_IN a_DT jewel_NN —_NN or_CC hardly_RB visible_JJ ?_SENT Four_CD legs_NNS ?_SENT Two_CD legs_NNS ?_SENT No_DT legs_NNS at_IN all_DT ?_SENT When_WRB you_PP 're_VBP talking_VVG about_IN lizards_NNS and_CC snakes_NNS —_NN the_DT squamates_NNS —_NN the_DT answer_NN is_VBZ usually_RB ..._: ._SENT Yes_UH !_SENT This_DT ancient_JJ group_NN ,_, whose_WP$ scientific_JJ name_NN is_VBZ Latin_JJ for_IN scaled_VVN ,_, is_VBZ more_RBR diverse_JJ than_IN mammals_NNS ,_, as_RB old_JJ as_IN dinosaurs_NNS ._SENT And_CC they_PP 're_VBP almost_RB everywhere_RB :_: harsh_JJ desert_NN to_TO lush_JJ rainforest_NN ,_, high_JJ in_IN the_DT treetops_NNS ,_, beneath_IN the_DT ground_NN ._SENT Whatever_WDT the_DT environment_NN ,_, one_CD of_IN the_DT 8_CD ,_, 000_CD squamate_JJ species_NNS on_IN Earth_NP calls_VVZ it_PP home_NN ._SENT We_PP share_VVP the_DT planet_NN ,_, but_CC we_PP often_RB overlook_VVP these_DT quiet_JJ neighbors_NNS ._SENT So_RB welcome_JJ to_TO the_DT world_NN of_IN squamates_NNS ,_, and_CC get_VV ready_JJ to_TO be_VB surprised_VVN !_SENT	引起读者兴趣
So_RB welcome_JJ to_TO the_DT world_NN of_IN squamates_NNS ,_, and_CC get_VV ready_JJ to_TO be_VB surprised_VVN !_SENT	引起读者兴趣
Countless_JJ species_NNS ,_, living_VVG and_CC extinct--why_RB so_RB many_JJ ?_SENT	引起读者兴趣
Just_RB ask_VV yourself_PP :_: Do_VVP I_PP act_VV based_VVN on_IN what_WP I_PP know_VVP ,_, or_CC how_WRB I_PP feel_VVP ?_SENT	引起读者兴趣
Countless_JJ species_NNS ,_, living_VVG and_CC extinct--why_RB so_RB many_JJ ?_SENT Some_DT were_VBD only_RB slightly_RB different_JJ from_IN one_CD another--what_NN could_MD explain_VV that_DT ?_SENT Each_DT organism_NN so_RB beautifully_RB adapted_VVN to_TO its_PP$ environment--how_NN could_MD it_PP happen_VV ?_SENT	引起读者兴趣
What_WP purpose_NN ,_, we_PP wonder_VVP ,_, could_MD they_PP serve_VV ?_SENT	引起读者兴趣
Narwhal_NN :_: Revealing_VVG an_DT Arctic_NP Legend_NP will_MD present_VV Inuit_NP perspectives_NNS on_IN their_PP$ connections_NNS to_TO narwhals_NNS as_RB well_RB as_IN the_DT latest_JJS scientific_JJ knowledge_NN about_IN these_DT fascinating_JJ animals_NNS ._SENT	说明展览内容
The_DT David_NP H_NP ._SENT Koch_NP Hall_NP of_IN Human_NP Origins_NP offers_VVZ visitors_NNS an_DT immersive_NN ,_, interactive_JJ journey_NN through_IN 6_CD million_CD years_NNS of_IN scientific_JJ evidence_NN for_IN human_JJ origins_NNS and_CC the_DT stories_NNS of_IN survival_NN and_CC extinction_NN ?_SENT in_IN our_PP$ family_NN tree_NN during_IN times_NNS of_IN dramatic_JJ climate_NN instability_NN ._SENT	说明展览内容
The_DT exhibit_NN highlights_VVZ the_DT diversity_NN and_CC unity_NN of_IN every_DT major_JJ group_NN of_IN vertebrates_NNS ,_, supporting_VVG ideas_NNS of_IN evolution_NN and_CC common_JJ ancestry_NN ._SENT	说明展览内容
Exhibition_NN highlights_NNS include_VVP :_: see_VV the_DT enchanting_JJ flower_NN urchin_NN ,_, whose_WP$ venom_NN can_MD cause_VV temporary_JJ muscular_JJ paralysis_NN in_IN humans_NNS	说明展览内容
Exhibition_NN highlights_NNS include_VVP :_: discover_VV the_DT unusual_JJ love_NN life_NN of_IN the_DT emperor_NN scorpion_NN -_: where_WRB seduction_NN has_VHZ a_DT sting_NN in_IN the_DT tail_JJ	说明展览内容
The_DT Brain_NP Diaries_NP exhibition_NN and_CC event_NN programme_NN reveal_VV how_WRB the_DT latest_JJS neuroscience_NN is_VBZ transforming_VVG what_WP we_PP know_VVP about_IN our_PP$ brains_NNS ,_, from_IN birth_NN to_TO the_DT end_NN of_IN life_NN ._SENT	说明展览内容
This_DT exhibition_NN ,_, curated_VVD by_IN Mark_NP Siddall_NP ,_, curator_NN in_IN the_DT Division_NP of_IN Invertebrate_NP Zoology_NP ,_, features_VVZ more_JJR than_IN 20_CD sets_NNS of_IN large-format_NN images_NNS that_WDT showcase_VVP the_DT wide_JJ range_NN of_IN research_NN being_VBG conducted_VVN at_IN the_DT Museum_NP as_RB well_RB as_IN how_WRB various_JJ optical_JJ tools_NNS are_VBP used_VVN in_IN scientific_JJ studies_NNS	说明展览内容
Narrated_VVN by_IN Academy_NP Award-winning_JJ ?_SENT actress_NN Cate_NP Blanchett_NP ,_, Earthflight_NP ?_SENT is_VBZ a_DT totally_RB immersive_JJ experience_NN ,_, taking_VVG the_DT audience_NN on_IN an_DT incredible_JJ flight_NN across_IN the_DT world_NN on_IN the_DT wings_NNS of_IN birds_NNS ._SENT	说明展览内容
Get_VVP up_RB close_VV to_TO all_DT kinds_NNS of_IN specimens_NNS ,_, from_IN snakes_NNS ,_, centipedes_NNS ,_, snails_NNS and_CC scorpions_NNS to_TO the_DT unassuming_JJ platypus_NN ._SENT	说明读者可以做什么
Explore_VV whales_NNS ,_, dolphins_NNS and_CC porpoises_NNS '_POS extraordinary_JJ adaptations_NNS to_TO their_PP$ underwater_JJ environments_NNS ,_, and_CC learn_VV how_WRB they_PP are_VBP similar_JJ to_TO us_PP ._SENT	说明读者可以做什么
Meet_VV its_PP$ people_NNS ,_, explore_VV its_PP$ landscapes_NNS and_CC encounter_VV its_PP$ rare_JJ and_CC unusual_JJ species_NN	说明读者可以做什么
Understanding_VVG this_DT process_NN might_MD help_VV us_PP to_TO cope_VV with_IN shift_NN work_NN and_CC jet_NN lag_NN ,_, and_CC to_TO improve_VV our_PP$ working_VVG environments_NNS ._SENT	介绍展览的意义
Bees_NNS are_VBP one_CD of_IN the_DT major_JJ groups_NNS of_IN insects_NNS ,_, numbering_VVG about_IN 20_CD ,_, 000_CD described_VVN species_NNS ._SENT	介绍相关内容
If_IN there_EX is_VBZ one_CD person_NN who_WP has_VHZ a_DT very_RB special_JJ knowledge_NN of_IN our_PP$ amazing_JJ building_NN and_CC collections_NNS ,_, it_PP is_VBZ Chris_NP Burras_NP ._SENT	介绍相关内容
Chris_NP ,_, who_WP was_VBD Head_NP of_IN Technical_NP Services_NPS for_IN many_JJ years_NNS ,_, retired_VVN in_IN 2013_CD ,_, and_CC here_RB he_PP describes_VVZ some_DT his_PP$ favourite_JJ things_NNS in_IN the_DT Museum_NP ._SENT	介绍相关内容
scales_NNS are_VBP one_CD thing_NN all_DT squamates_NNS have_VHP in_RB common_JJ ._SENT	介绍相关内容
The_DT smallest_JJS bird_NN has_VHZ powers_NNS we_PP will_MD never_RB share_VV ._SENT	介绍相关内容
Earth’s_NP climate_NN is_VBZ changing_VVG ._SENT Global_JJ temperature_NN is_VBZ rising_VVG ,_, weather_NN patterns_NNS are_VBP shifting_VVG ,_, and_CC other_JJ effects_NNS may_MD be_VB on_IN our_PP$ horizon_NN ._SENT	介绍相关内容
The_DT last_JJ few_JJ decades_NNS have_VHP seen_VVN larger_JJR areas_NNS of_IN the_DT world_NN enduring_VVG longer_JJR —_NN and_CC drier_JJR —_JJ droughts_NNS ._SENT	介绍相关内容
This_DT unforgettable_JJ night_NN of_IN oceanic_JJ proportions_NNS is_VBZ hosted_VVN in_IN collaboration_NN with_IN Guilty_NP Pleasures_NP and_CC inspired_VVN by_IN the_DT arrival_NN of_IN the_DT blue_JJ whale_NN in_IN the_DT newly_RB redeveloped_VVN Hintze_NP Hall_NP ._SENT	概括性介绍整个展览
The_DT O_NN ._SENT Orkin_NP Insect_NP Zoo_NP is_VBZ a_DT special_JJ exhibit_NN hall_NN on_IN the_DT 2nd_JJ Floor_NN of_IN the_DT Museum_NP where_WRB visitors_NNS can_MD observe_VV live_JJ insects_NNS and_CC their_PP$ many-legged_JJ relatives_NNS ._SENT	概括性介绍整个展览
Please_VV click_NN on_IN the_DT picture_NN to_TO the_DT left_NN for_IN the_DT full_JJ page_NN ._SENT	查看更多内容