Come_VV face-to-face_RB with_IN more_JJR than_IN 200_CD examples_NNS of_IN the_DT Earth’s_NP extraordinary_JJ mammal_NN diversity_NN ._SENT	祈使句
Ever_RB wanted_VVD to_TO look_VV a_DT koala_NN ,_, a_DT hippopotamus_NN ,_, or_CC a_DT gorilla_NN in_IN the_DT eye_NN ?_SENT	疑问句
Dive_NN in_IN !_SENT	感叹句
Encounter_VV some_DT of_IN the_DT world_NN 's_POS most_RBS venomous_JJ creatures_NNS and_CC discover_VV their_PP$ surprising_JJ connection_NN to_TO human_JJ health_NN ._SENT	祈使句
Get_VVP up_RB close_VV to_TO all_DT kinds_NNS of_IN specimens_NNS ,_, from_IN snakes_NNS ,_, centipedes_NNS ,_, snails_NNS and_CC scorpions_NNS to_TO the_DT unassuming_JJ platypus_NN ._SENT	祈使句
Find_VV out_RP how_WRB across_IN cultures_NNS and_CC time_NN ,_, humans_NNS have_VHP found_VVN creative_JJ ways_NNS to_TO neutralise_VV and_CC harness_VV the_DT properties_NNS of_IN venom_NN ,_, and_CC how_WRB today_NN some_RB of_IN nature_NN 's_POS deadliest_JJS venoms_NNS are_VBP actually_RB saving_VVG lives_NNS ._SENT	陈述句
Please_UH note_VV this_DT exhibition_NN contains_VVZ images_NNS that_IN/that some_DT may_MD find_VV distressing_JJ ._SENT	祈使句
Exhibition_NN highlights_NNS include_VVP :_: see_VV the_DT enchanting_JJ flower_NN urchin_NN ,_, whose_WP$ venom_NN can_MD cause_VV temporary_JJ muscular_JJ paralysis_NN in_IN humans_NNS	陈述句
Exhibition_NN highlights_NNS include_VVP :_: discover_VV the_DT unusual_JJ love_NN life_NN of_IN the_DT emperor_NN scorpion_NN -_: where_WRB seduction_NN has_VHZ a_DT sting_NN in_IN the_DT tail_JJ	陈述句
Meet_VV the_DT monster_NN whose_WP$ bite_NN is_VBZ saving_VVG lives_NNS	祈使句
Find_VV out_IN about_RB five_CD animals_NNS that_IN/that you_PP might_MD not_RB expect_VV to_TO be_VB venomous_JJ	祈使句
Explore_VV whales_NNS ,_, dolphins_NNS and_CC porpoises_NNS '_POS extraordinary_JJ adaptations_NNS to_TO their_PP$ underwater_JJ environments_NNS ,_, and_CC learn_VV how_WRB they_PP are_VBP similar_JJ to_TO us_PP ._SENT	祈使句
See_VV how_WRB whales_NNS became_VVD sociable_JJ ,_, aquatic_JJ mammals_NNS ,_, some_DT of_IN which_WDT can_MD communicate_VV over_IN vast_JJ distances_NNS ._SENT	祈使句
Richard_NP Sabin_NP ,_, whale_NN expert_NN at_IN the_DT Museum_NP ,_, says_VVZ ,_, '_'' Whales_NP are_VBP incredibly_RB mysterious_JJ and_CC complex_JJ creatures_NNS ,_, and_CC the_DT giants_NNS of_IN the_DT seas_NNS ._SENT	陈述句
This_DT unforgettable_JJ night_NN of_IN oceanic_JJ proportions_NNS is_VBZ hosted_VVN in_IN collaboration_NN with_IN Guilty_NP Pleasures_NP and_CC inspired_VVN by_IN the_DT arrival_NN of_IN the_DT blue_JJ whale_NN in_IN the_DT newly_RB redeveloped_VVN Hintze_NP Hall_NP ._SENT	陈述句
Pick_VV up_RP your_PP$ complimentary_JJ drink_NN when_WRB you_PP arrive_VVP and_CC immerse_VVP yourself_PP in_IN the_DT Museum_NP 's_POS stunning_JJ surroundings_NN ._SENT	祈使句
Ever_RB wonder_VV what_WP happens_VVZ in_IN the_DT Museum_NP when_WRB everyone_NN 's_VBZ gone_VVN home_RB ?_SENT	疑问句
Do_VV you_PP have_VHP what_WP it_PP takes_VVZ to_TO catch_VV a_DT killer_NN ?_SENT	疑问句
Please_UH be_VB aware_JJ that_IN/that you_PP may_MD miss_VV some_DT of_IN the_DT activities_NNS if_IN you_PP arrive_VVP late_RB ._SENT	祈使句
The_DT Brain_NP Diaries_NP exhibition_NN and_CC event_NN programme_NN reveal_VV how_WRB the_DT latest_JJS neuroscience_NN is_VBZ transforming_VVG what_WP we_PP know_VVP about_IN our_PP$ brains_NNS ,_, from_IN birth_NN to_TO the_DT end_NN of_IN life_NN ._SENT	陈述句
John_NP Eddowes_NP Bowman_NP (_( 1785-1841_CD )_) was_VBD a_DT banker_NN and_CC naturalist_NN based_VVN in_IN the_DT north_NN of_IN England_NP ,_, and_CC although_IN not_RB widely_RB known_VVN he_PP was_VBD a_DT fellow_NN of_IN the_DT Linnean_JJ Society_NP of_IN London_NP ,_, and_CC of_IN the_DT Geological_NP Society_NP ,_, and_CC also_RB a_DT founding_JJ fellow_NN of_IN the_DT Manchester_NP Geological_NP Society_NP ._SENT	陈述句
The_DT results_NNS of_IN a_DT creative_JJ collaboration_NN between_IN brain_NN injury_NN association_NN Headway_NP Oxfordshire_NP and_CC poet_NN Kelley_NP Swain_NP ,_, who_WP drew_VVD on_IN the_DT Museum_NP 's_POS Brain_NP Diaries_NP exhibition_NN for_IN inspiration_NN ._SENT	无谓语
The_DT remarkable_JJ use_NN of_IN tools_NNS by_IN non-human_NN primates_NNS ,_, based_VVN on_IN research_NN from_IN the_DT University_NP of_IN Oxford抯_NP Primate_NP Archaeology_NP Project_NP ._SENT	无谓语
A_DT banker_NN and_CC self-taught_JJ naturalist_NN who_WP devoted_VVD himself_PP almost_RB entirely_RB to_TO geology_NN in_IN the_DT last_JJ years_NNS of_IN his_PP$ life_NN ,_, John_NP Eddowes_NP Bowman_NP 's_POS remarkable_JJ collection_NN has_VHZ just_RB been_VBN unwrapped_VVN from_IN its_PP$ newspaper_NN for_IN the_DT first_JJ time_NN in_IN nearly_RB 100_CD years_NNS ._SENT	陈述句
He_PP was_VBD best_RBS known_VVN for_IN his_PP$ scientific_JJ contributions_NNS to_TO entomology_NN ,_, the_DT study_NN of_IN insects_NNS ._SENT	陈述句
Although_IN it_PP is_VBZ now_RB an_DT icon_NN of_IN extinction_NN ,_, it_PP was_VBD n't_RB until_IN the_DT 19th_JJ century_NN that_IN/that interest_NN in_IN the_DT Oxford_NP Dodo_NP grew_VVD from_IN scientific_JJ publications_NNS about_IN the_DT extinction_NN of_IN dodos_NNS ._SENT	陈述句
How_WRB spiders_NNS linked_VVD the_DT world_NN together_RB ,_, and_CC the_DT man_NN at_IN the_DT centre_NN of_IN it_PP all_RB ._SENT	陈述句
Bees_NNS are_VBP one_CD of_IN the_DT major_JJ groups_NNS of_IN insects_NNS ,_, numbering_VVG about_IN 20_CD ,_, 000_CD described_VVN species_NNS ._SENT	陈述句
What_WP role_NN did_VVD John_NP Woodhouse_NP play_NN in_IN Audubon_NP 's_POS last_JJ years_NNS and_CC what_WP legacy_NN did_VVD he_PP leave_VVP behind_RB ?_SENT	疑问句
Madagascan_JJ specimens_NNS ,_, including_VVG this_DT Sunset_NN Moth_NN ,_, from_IN the_DT Museum_NP 's_POS collections_NNS ._SENT	无谓语
The_DT last_JJ person_NN to_TO see_VV these_DT insects_NNS alive_RB was_VBD Charles_NP Darwin_NP ._SENT	陈述句
They_PP were_VBD collected_VVN in_IN Australia_NP and_CC Tasmania_NP and_CC sent_VVD back_RB to_TO England_NP for_IN identification_NN ._SENT	陈述句
Decorated_VVN pine_NN trees_NNS are_VBP a_DT festive_JJ essential_JJ ,_, so_RB we_PP invited_VVD our_PP$ colleagues_NNS at_IN the_DT University_NP of_IN Oxford_NP 's_POS Herbaria_NP to_TO share_VV a_DT few_JJ of_IN their_PP$ favourites_NNS ._SENT	陈述句
The_DT evolutionary_JJ adaptations_NNS of_IN this_DT most_RBS basic_JJ life_NN function_NN are_VBP many_JJ and_CC varied_JJ :_: a_DT simple_JJ breath_NN is_VBZ not_RB so_RB simple_JJ after_IN all_DT ._SENT	陈述句
We_PP look_VVP at_IN insects_NNS that_WDT have_VHP evolved_VVN to_TO resemble_VV another_DT in_IN order_NN to_TO trick_VV prey_NN or_CC predators_NNS ,_, and_CC ones_NNS that_WDT use_VVP camouflage_NN ,_, by_IN mimicking_VVG bark_NN or_CC leaves_VVZ ._SENT	陈述句
This_DT was_VBD an_DT incredible_JJ feat_NN ,_, requiring_VVG an_DT enormous_JJ breadth_NN of_IN geological_JJ knowledge_NN ._SENT	陈述句
Thursday_NP 7_CD November_NP 2013_CD marked_VVD the_DT centenary_NN of_IN the_DT death_NN of_IN Alfred_NP Russel_NP Wallace_NP ,_, one_CD of_IN the_DT 19th-century_NN 's_POS greatest_JJS explorers_NNS and_CC naturalists_NNS ._SENT	陈述句
At_IN 9_CD o'clock_RB in_IN the_DT morning_NN on_IN September_NP 10th_JJ ,_, 1813_CD ,_, the_DT residents_NNS of_IN County_NP Limerick_NP in_IN Ireland_NP had_VHD a_DT bit_NN of_IN a_DT surprise_NN ._SENT	陈述句
More_JJR than_IN 48kg_JJ of_IN rock_NN had_VHD just_RB arrived_VVN on_IN Earth_NN from_IN space_NN !_SENT	感叹句
If_IN there_EX is_VBZ one_CD person_NN who_WP has_VHZ a_DT very_RB special_JJ knowledge_NN of_IN our_PP$ amazing_JJ building_NN and_CC collections_NNS ,_, it_PP is_VBZ Chris_NP Burras_NP ._SENT	陈述句
Chris_NP ,_, who_WP was_VBD Head_NP of_IN Technical_NP Services_NPS for_IN many_JJ years_NNS ,_, retired_VVN in_IN 2013_CD ,_, and_CC here_RB he_PP describes_VVZ some_DT his_PP$ favourite_JJ things_NNS in_IN the_DT Museum_NP ._SENT	陈述句
Thinking_VVG that_IN/that the_DT piece_NN of_IN shale_NN rock_NN he_PP had_VHD collected_VVN while_IN on_IN holiday_NN in_IN Cornwall_NP might_MD contain_VV a_DT fossilised_VVN imprint_NN ,_, Bruno_NP showed_VVD the_DT specimen_NN to_TO our_PP$ Education_NP department_NN 's_POS Natural_JJ History_NN After-School_NN Club_NP ,_, which_WDT he_PP had_VHD been_VBN attending_VVG each_DT week_NN ._SENT	陈述句
Please_VV click_NN on_IN the_DT picture_NN to_TO the_DT left_NN for_IN the_DT full_JJ page_NN ._SENT	祈使句
Discover_VV how_WRB this_DT former_JJ lawyer_NN helped_VVD to_TO change_VV geology_NN forever_RB ._SENT	祈使句
Typically_RB humans_NNS can_MD see_VV wavelengths_NNS of_IN 390-700_CD nanometres_NNS ,_, with_IN the_DT lower_JJR wavelengths_NNS perceived_VVN as_IN blue_JJ ,_, and_CC the_DT higher_JJR ones_NNS as_IN red_NN ._SENT	陈述句
To_TO illustrate_VV the_DT iridescent_JJ colours_NNS of_IN some_DT species_NN ,_, gold_NN leaf_NN was_VBD added_VVN to_TO the_DT watercolour_NN illustrations_NNS ._SENT	陈述句
Keep_VV an_DT eye_NN out_RP on_IN the_DT Microsculpture_NP website_NN and_CC Levon’s_NP social_JJ media_NN channels_NNS to_TO find_VV out_RP more_JJR about_IN book_NN events_NNS ._SENT	祈使句
The_DT show_NN will_MD run_VV for_IN 6_CD months_NNS and_CC is_VBZ expected_VVN to_TO be_VB a_DT popular_JJ feature_NN in_IN the_DT city_NN for_IN the_DT summer_NN ,_, incorporating_VVG educational_JJ days_NNS and_CC science_NN talks_NNS promoting_VVG the_DT understanding_NN of_IN the_DT insect_NN world_NN ._SENT	陈述句
The_DT partnership_NN is_VBZ to_TO continue_VV ,_, with_IN future_JJ shows_NNS in_IN New_NP York_NP at_IN the_DT end_NN of_IN the_DT summer_NN ._SENT	陈述句
2017_CD started_VVN with_IN a_DT wonderful_JJ Microsculpture_NP show_NN NMB_NP Museum_NP in_IN Biel_NP ,_, Switzerland_NP ._SENT	陈述句
Also_RB on_IN display_NN were_VBD the_DT actual_JJ insects_NNS from_IN the_DT Oxford_NP Museum_NP Museum_NP of_IN Natural_NP History_NN ,_, providing_VVG the_DT audience_NN with_IN a_DT real_JJ sense_NN of_IN scale_NN and_CC an_DT unique_JJ visual_JJ experience_NN ._SENT	倒装句
To_TO find_VV out_RP if_IN they_PP are_VBP alone_RB or_CC in_IN a_DT crowd_NN bacteria_NNS release_VVP a_DT chemical_NN into_IN their_PP$ environment_NN ._SENT	祈使句
Sensors_NNS in_IN our_PP$ cells_NNS respond_VV when_WRB levels_NNS of_IN oxygen_NN fall_NN to_TO dangerous_JJ levels_NNS ,_, triggering_VVG changes_NNS that_WDT bring_VVP more_JJR oxygen_NN to_TO the_DT tissues_NNS ._SENT	陈述句
Understanding_VVG this_DT process_NN might_MD help_VV us_PP to_TO cope_VV with_IN shift_NN work_NN and_CC jet_NN lag_NN ,_, and_CC to_TO improve_VV our_PP$ working_VVG environments_NNS ._SENT	陈述句
If_IN shaping_VVG the_DT natural_JJ world_NN is_VBZ a_DT sign_NN of_IN civilization_NN ,_, the_DT Nabataeans_NP were_VBD one_CD of_IN the_DT most_RBS civilized_JJ peoples_NNS of_IN antiquity_NN ._SENT	陈述句
This_DT exhibition_NN ,_, curated_VVD by_IN Mark_NP Siddall_NP ,_, curator_NN in_IN the_DT Division_NP of_IN Invertebrate_NP Zoology_NP ,_, features_VVZ more_JJR than_IN 20_CD sets_NNS of_IN large-format_NN images_NNS that_WDT showcase_VVP the_DT wide_JJ range_NN of_IN research_NN being_VBG conducted_VVN at_IN the_DT Museum_NP as_RB well_RB as_IN how_WRB various_JJ optical_JJ tools_NNS are_VBP used_VVN in_IN scientific_JJ studies_NNS	陈述句
Neither_DT birds_NNS nor_CC bats_NNS ,_, pterosaurs_NNS were_VBD reptiles_NNS ,_, close_JJ cousins_NNS of_IN dinosaurs_NNS who_WP evolved_VVD on_IN a_DT separate_JJ branch_NN of_IN the_DT reptile_JJ family_NN tree_NN ._SENT	陈述句
At_IN 15_CD he_PP became_VVD a_DT midshipman_NN and_CC began_VVD a_DT steady_JJ progression_NN up_IN the_DT career_NN ladder_NN of_IN the_DT Royal_NP Navy_NP ,_, becoming_VVG a_DT lieutenant_NN specializing_VVG in_IN the_DT new_JJ technology_NN of_IN torpedoes_NNS in_IN 1889._CD	陈述句
If_IN they_PP did_VVD n't_RB get_VV what_WP they_PP needed_VVD in_IN their_PP$ sole_JJ throw_NN of_IN the_DT dice_NN ,_, they_PP were_VBD out_RP of_IN luck_NN ._SENT	陈述句
After_IN camping_VVG on_IN the_DT ice_NN for_IN five_CD months_NNS ,_, Shackleton_NP made_VVD two_CD open_JJ boat_NN journeys_NNS ,_, one_CD of_IN which--a_NN treacherous_JJ 800-mile_JJ ocean_NN crossing_VVG to_TO South_NP Georgia_NP Island--is_NP now_RB considered_VVD one_CD of_IN the_DT greatest_JJS boat_NN journeys_NNS in_IN history_NN ._SENT	陈述句
More_JJR than_IN just_RB the_DT narration_NN ,_, it_PP is_VBZ the_DT visuals_NNS that_WDT will_MD blow_VV you_PP away_RP ._SENT	强调句
Here_RB are_VBP some_DT tips_NNS for_IN creating_VVG your_PP$ own_JJ garden_NN ._SENT	倒装句
While_IN many_JJ jewelers_NNS still_RB work_VVP in_IN classic_JJ silver-and-turquoise_NN styles_NNS ,_, Navajo_NP jewelry_NN today_NN is_VBZ strongly_RB marked_VVN by_IN its_PP$ great_JJ diversity_NN and_CC innovation_NN ._SENT	陈述句
A_DT thrilling_JJ journey_NN along_IN the_DT greatest_JJS trading_NN route_NN in_IN history--the_NNS legendary_JJ Silk_NP Road_NP ._SENT	无谓语
Who_WP is_VBZ best_RBS suited_VVN to_TO tell_VV you_PP more_JJR about_IN dinosaurs_NNS ?_SENT Undoubtedly_RB the_DT men_NNS and_CC women_NNS who_WP discovered_VVD and_CC studied_VVD them_PP !_SENT	疑问句连着感叹句
Did_VVD you_PP know_VVP that_IN/that arthropods_NNS make_VVP up_RP nearly_RB 80_CD %_NN of_IN known_VVN animal_NN species_NNS ?_SENT And_CC entomologists_NNS are_VBP discovering_VVG new_JJ ones_NNS every_DT day_NN ._SENT There_EX should_MD be_VB a_DT whole_JJ museum_NN devoted_VVN to_TO them_PP !_SENT	疑问句连着感叹句
Allow_VV yourself_PP to_TO delight_VV in_IN the_DT splendid_JJ colours_NNS and_CC gorgeous_JJ shapes_NNS of_IN some_DT of_IN the_DT finest_JJS pieces_NNS in_IN our_PP$ collection_NN ._SENT	祈使句
Foxes_NNS are_VBP omnivores_NNS and_CC opportunists_NNS :_: they_PP find_VVP plenty_NN of_IN food_NN in_IN gardens_NNS (_( small_JJ rodents_NNS ,_, earthworms_NNS ,_, beetles_NNS ,_, fruits_NNS ,_, and_CC berries_NNS )_) ,_, pet_JJ food_NN bowls_NNS ,_, and_CC ,_, of_IN course_NN ,_, bins_NNS !_SENT	冒号进一步解释
Prehistoric_JJ man_NN used_VVD it_PP to_TO make_VV fire_NN :_: striking_JJ pyrite_NN against_IN flint_NN until_IN there_EX were_VBD sparks_NNS ._SENT	冒号进一步解释
Then_RB ,_, using_VVG simulations_NNS ,_, you_PP will_MD explore_VV the_DT marvellous_JJ and_CC complex_JJ machine_NN that_WDT is_VBZ our_PP$ body_NN ,_, its_PP$ development_NN ,_, how_WRB it_PP works_VVZ and_CC what_WP it_PP needs_VVZ to_TO survive_VV and_CC reproduce_VV (_( that_WDT should_MD get_VV your_PP$ teenagers_NNS interested_JJ !_SENT )_)	括号注释补充信息
Birds_NNS are_VBP the_DT descendants_NNS of_IN theropods_NNS (_( sometimes_RB they_PP are_VBP even_RB considered_VVN to_TO be_VB dinosaurs_NNS )_) ._SENT	括号注释补充信息
You_PP can_MD still_RB take_VV a_DT virtual_JJ look_NN inside_IN the_DT halls_NNS thanks_NNS to_TO Google_NP Street_NP View_NP (_( click_NN on_IN the_DT yellow_JJ guy_NN down_RB on_IN the_DT right_NN ,_, then_RB select_VV the_DT third_JJ floor_NN in_IN the_DT upper_JJ banner_NN )_) ._SENT	括号注释补充信息
These_DT have_VHP a_DT muscular_JJ foot_NN ,_, which_WDT they_PP use_VVP to_TO move_VV themselves_PP along_IN (_( either_CC by_IN crawling_VVG ,_, like_IN most_JJS ,_, or_CC swimming_VVG in_IN some_DT aquatic_JJ species_NN )_) ._SENT	括号注释补充信息
But_CC did_VVD they_PP really_RB disappear_VVP ?_SENT We’re_NP not_RB so_RB sure_JJ ..._:	设问
With_IN a_DT bit_NN of_IN luck_NN you_PP can_MD even_RB observe_VV him_PP working_JJ (_( through_IN the_DT window_NN of_IN our_PP$ secure_JJ laboratory_NN )_) !_SENT	感叹句
Who_WP looks_VVZ after_IN the_DT young_JJ ?_SENT What_WP do_VVP baby_NN animals_NNS eat_VVP ?_SENT How_WRB do_VVP they_PP learn_VVP to_TO run_VV ,_, swim_VVP or_CC fly_VVP ?_SENT	排比句
Every_DT year_NN ,_, throughout_IN April_NP and_CC May_NP ,_, you_PP can_MD follow_VV their_PP$ little_JJ family_NN as_IN it_PP develops_VVZ ,_, from_IN the_DT eggs_NNS being_VBG laid_VVN to_TO the_DT fledging_VVG of_IN the_DT young_JJ eyasses_NNS ._SENT	第二人称
With_IN a_DT surface_NN area_NN of_IN over_RB 3000_CD m2_NN and_CC dozens_NNS of_IN specimens_NNS ,_, the_DT Dinosaur_NP Gallery_NP is_VBZ the_DT largest_JJS room_NN in_IN Europe_NP entirely_RB devoted_VVD to_TO dinosaurs_NNS ,_, their_PP$ discovery_NN ,_, lives_NNS and_CC evolution_NN ._SENT	with结构
With_IN their_PP$ long_JJ ,_, hydrodynamic_JJ bodies_NNS ;_: supple_JJ ,_, muscular_JJ tails_NNS ending_VVG in_IN an_DT efficient_JJ bi-lobed_JJ tail_NN fluke_NN ;_: and_CC limbs_NNS transformed_VVN into_IN flippers_NNS for_IN balance_NN and_CC steering_NN ,_, the_DT large_JJ mosasaurs_NNS exhibited_VVN in_IN this_DT room_NN were_VBD certainly_RB fast_JJ swimmers_NNS ,_, and_CC with_IN their_PP$ powerful_JJ jaws_NNS ,_, also_RB dangerous_JJ predators_NNS !_SENT	with结构
So_RB massive_JJ !_SENT So_RB tall_JJ !_SENT Such_JJ long_JJ necks_NNS and_CC tiny_JJ heads_NNS !_SENT But_CC more_RBR astounding_VVG is_VBZ this_DT :_:	感叹句
Small_JJ and_CC shy_JJ —_NN or_CC big_JJ and_CC fierce_JJ ?_SENT Bright_JJ as_IN a_DT jewel_NN —_NN or_CC hardly_RB visible_JJ ?_SENT Four_CD legs_NNS ?_SENT Two_CD legs_NNS ?_SENT No_DT legs_NNS at_IN all_DT ?_SENT When_WRB you_PP 're_VBP talking_VVG about_IN lizards_NNS and_CC snakes_NNS —_NN the_DT squamates_NNS —_NN the_DT answer_NN is_VBZ usually_RB ..._: ._SENT Yes_UH !_SENT This_DT ancient_JJ group_NN ,_, whose_WP$ scientific_JJ name_NN is_VBZ Latin_JJ for_IN scaled_VVN ,_, is_VBZ more_RBR diverse_JJ than_IN mammals_NNS ,_, as_RB old_JJ as_IN dinosaurs_NNS ._SENT And_CC they_PP 're_VBP almost_RB everywhere_RB :_: harsh_JJ desert_NN to_TO lush_JJ rainforest_NN ,_, high_JJ in_IN the_DT treetops_NNS ,_, beneath_IN the_DT ground_NN ._SENT Whatever_WDT the_DT environment_NN ,_, one_CD of_IN the_DT 8_CD ,_, 000_CD squamate_JJ species_NNS on_IN Earth_NP calls_VVZ it_PP home_NN ._SENT We_PP share_VVP the_DT planet_NN ,_, but_CC we_PP often_RB overlook_VVP these_DT quiet_JJ neighbors_NNS ._SENT So_RB welcome_JJ to_TO the_DT world_NN of_IN squamates_NNS ,_, and_CC get_VV ready_JJ to_TO be_VB surprised_VVN !_SENT	设问
So_RB welcome_JJ to_TO the_DT world_NN of_IN squamates_NNS ,_, and_CC get_VV ready_JJ to_TO be_VB surprised_VVN !_SENT	祈使句
Countless_JJ species_NNS ,_, living_VVG and_CC extinct--why_RB so_RB many_JJ ?_SENT	疑问句
Just_RB ask_VV yourself_PP :_: Do_VVP I_PP act_VV based_VVN on_IN what_WP I_PP know_VVP ,_, or_CC how_WRB I_PP feel_VVP ?_SENT	祈使句
Meet_VV its_PP$ people_NNS ,_, explore_VV its_PP$ landscapes_NNS and_CC encounter_VV its_PP$ rare_JJ and_CC unusual_JJ species_NN	祈使句
Hidden_VVN from_IN view_NN ,_, shielded_VVN from_IN the_DT elements_NNS ,_, caves_NNS harbor_VVP tantalizing_VVG traces_NNS of_IN Cuba’s_NP past_NN ._SENT	定语前置
Among_IN the_DT items_NNS selected_VVN for_IN the_DT capsule_NN were_VBD the_DT six_CD millennium_NN issues_NNS of_IN The_DT New_NP York_NP Times_NP Magazine_NP preserved_VVD in_IN two_CD forms_NNS	倒装
Earth’s_NP climate_NN is_VBZ changing_VVG ._SENT Global_JJ temperature_NN is_VBZ rising_VVG ,_, weather_NN patterns_NNS are_VBP shifting_VVG ,_, and_CC other_JJ effects_NNS may_MD be_VB on_IN our_PP$ horizon_NN ._SENT	排比句
Countless_JJ species_NNS ,_, living_VVG and_CC extinct--why_RB so_RB many_JJ ?_SENT Some_DT were_VBD only_RB slightly_RB different_JJ from_IN one_CD another--what_NN could_MD explain_VV that_DT ?_SENT Each_DT organism_NN so_RB beautifully_RB adapted_VVN to_TO its_PP$ environment--how_NN could_MD it_PP happen_VV ?_SENT	疑问句
He_PP never_RB tired_JJ of_IN studying_VVG the_DT details_NNS of_IN the_DT natural_JJ world_NN ._SENT	无谓语
It_PP was_VBD here_RB that_IN/that he_PP brilliantly_RB put_VVD together_RB the_DT pieces_NNS of_IN his_PP$ theory_NN of_IN evolution_NN by_IN natural_JJ selection_NN ._SENT	强调句
What_WP purpose_NN ,_, we_PP wonder_VVP ,_, could_MD they_PP serve_VV ?_SENT	疑问句
Also_RB featured_VVN are_VBP many_JJ new_JJ specimens_NNS from_IN Mongolia_NP ,_, including_VVG a_DT number_NN of_IN species_NNS yet_RB to_TO be_VB named_VVN ,_, some_DT of_IN the_DT most_RBS complete_JJ meat-eating_VVG theropod_NN dinosaurs_NNS ever_RB found_VVD ,_, several_JJ nesting_VVG dinosaurs_NNS ,_, and_CC some_DT of_IN the_DT finest_JJS lizard_NN and_CC mammal_NN fossils_NNS ever_RB discovered_VVN ._SENT These_DT specimens_NNS have_VHP enhanced_VVN our_PP$ understanding_NN of_IN life_NN in_IN the_DT Gobi_NP region_NN 80_CD million_CD years_NNS ago_RB ,_, and_CC they_PP shed_VVD new_JJ light_NN on_IN the_DT rise_NN of_IN modern_JJ bird_NN and_CC mammal_NN groups_NNS ._SENT	倒装